
Stage 1
#####
#OoP#
#####
=====
Stage 2
  #######
###  O  ###
#    o    #
# Oo P oO #
###  o  ###
 #   O  #
 ########
=======
Stage 3
#############
#           #
#  Po o     #
######      #
# OOO#o     #
# O###      #
#     o     #
#           #
#############
=====
Stage 4
##########
#   ##   #
#  OOoOO #
## # # # #
 # ooo   #
 ###P ####
   ####
======
Stage 5
 #######
 #     ###
##o### o #
#    oP  #
# OO# o ##
##OO#   #
 ########